###############
#      @      #
#    b   b    #
# #         ###
# #    b    # #
# #    b    # #
# #    b    # #
# #    b    # #
#a#    b    # #
###h   b    # #
#    e    a   #
#  r        b #
######   ######
#      x    o*#
###############
